64
1 6
25 6
180
4000000000000000000000000000000000000000000000000000000000000000
4000000000000000000000000000000000000000000000000000000000000000
4000000001310000000000000000000000000000000000000000000000000000
4000000000000000000000000000000000000000000000000000000000000000
4000000222222220000000000000000000000000000000000000000000000000
4000000111331110000000000000000000000000000000000000000000000000
4000000000000000000000000000000000000000000000000000000000000000
4000000000000000000000000000000000000000000000000000000000000000
4444444444444444444444444400000000000000000000000000000000000000
